{
  "cmd": "STOP_LIVE_ROOM_LIST",
  "data": {
    "room_id_list": [
      1440955,
      22749255,
      22785228,
      2295559,
      6557472,
      7221183,
      10940055,
      21396562,
      24453260,
      25351084,
      6775966,
      7262051,
      8109754,
      13978750,
      2011110,
      23038086,
      23131657,
      25143086,
      22316561,
      23162940,
      23390576,
      25132999,
      25492068,
      25531562,
      25558530,
      6121362,
      25479066,
      5655301,
      764857,
      822973,
      20658,
      2305017,
      24943686,
      25277998,
      4079792,
      876715,
      21754887,
      21778981,
      24401723,
      24501845,
      371020,
      14652287,
      2052923,
      23351963,
      24697156,
      25388124,
      3735378,
      5340575,
      8348186,
      8647468,
      10512944,
      1849753,
      22973093,
      24397931,
      25227951,
      25483748,
      25527384,
      3200476,
      495225,
      6415083,
      10978588,
      21457654,
      22549556,
      22818283,
      24169713,
      25095572,
      25437045,
      25533740,
      518280,
      8882082,
      1386707,
      23647953,
      25284603,
      25453196,
      265576,
      3268623,
      7969239,
      12361763,
      21489999,
      21642876,
      22586283,
      24032368,
      24564786,
      25331761,
      3482545,
      3939917,
      4802465,
      10969315,
      15047275,
      24492970,
      24706612,
      25160942,
      25164085,
      25182905,
      25230824,
      25455151,
      6469189,
      23827615,
      24208133,
      24208873,
      24309992,
      25333874,
      25347284,
      25516122,
      25558711,
      11053010,
      11361170,
      24741742,
      25132195,
      323830,
      5089641,
      8681188,
      11107469,
      12264930,
      22433608,
      24383557,
      9277722,
      24603718,
      25346805,
      25369493,
      5810663,
      63758,
      1015873,
      10292761,
      13377587,
      21339103,
      23189514,
      24061006,
      25260671,
      4086767,
      8076059,
      933508,
      10484046,
      1466337,
      15026789,
      23151048,
      23552711,
      24074385,
      24885893,
      25196852,
      25372295,
      899820,
      11787501,
      22471656,
      25520227,
      4212823,
      6001345,
      9288932,
      1557147,
      22275828,
      23075875,
      24480718,
      24500023,
      24710330,
      24899431,
      25288789,
      5481549,
      5817989,
      6456919,
      1296015,
      13463841,
      22425586,
      22724030,
      25284641,
      25480275,
      3507086,
      570141,
      7552793,
      7588575,
      12012904,
      2094450,
      22760124,
      23457766,
      24140937,
      24512370,
      25211577,
      25558244,
      4076994,
      22463523,
      23836873,
      25493436,
      25525437,
      6959271,
      23454278,
      23990859,
      24243875,
      24804254,
      25000173,
      25182537,
      25220535,
      3285600,
      337613,
      9445814,
      1013524,
      21670641,
      22138129,
      24543369,
      38434,
      1045421,
      10843286,
      11881545,
      13330155,
      24338054,
      24558414,
      25519064,
      5579015,
      10172562,
      11669661,
      23080746,
      25181380,
      7352178,
      12311719,
      22802447,
      24407490,
      25395034,
      25558675,
      3052494,
      3524695,
      70093,
      1648258,
      23384307,
      24075628,
      25558650,
      7597257,
      833484
    ]
  }
}